#######################
#                     #
#      #      #       #
#                     #
#      ########       #
#                     #
#######################
#         .P          #
#       #######       #
#    ####G   G####    #
#    #  # ## ##  #    #
#    #     #     #    #
#    #     #     #    #
#          #          #
#      #########      #
#      #       #      #
#      #       #      #
#      #       #      #
#      #       #      #
#                     #
#######################