#######################
#.                   .#
#                     #
#                     #
#                     #
#                     #
#                     #
#          P          #
#                     #
#          .          #
#                     #
#                     #
#          G          #
#                     #
#                     #
#                     #
#                     #
#                     #
#                     #
#.                   .#
#######################